갖/VV	2급	갖다	VV
그치/VV	2급	그치다	VV
깨지/VV	3급	깨지다	VV
나타나/VV	2급	나타나다	VV
남/VV	2급	남다	VV
낳/VV	3급	낳다	VV
넘/VV	2급	넘다	VV
받아들이/VV	4급	받아들이다	VV
보/VV	1급	보다	VV
보이/VV	2급	보이다	VV
사라지/VV	3급	사라지다	VV
알/VV	1급	알다	VV
알아보/VV	2급	알아보다	VV
여기/VV	3급	여기다	VV
인하/VV	4급	인하다	VV
잇/VV	3급	잇다	VV
통하/VV	3급	통하다	VV
하/VV	1급	하다	VV
그렇/VA	1급	그렇다	VA
낮/VA	1급	낮다	VA
높/VA	1급	높다	VA
다르/VA	1급	다르다	VA
많/VA	1급	많다	VA
상관없/VA	3급	상관없다	VA
있/VA	1급	있다	VA
적/VA	1급	적다	VA
젊/VA	2급	젊다	VA
좋/VA	1급	좋다	VA
가부장적/NNG	5급	가부장적	NNG
가치관/NNG	4급	가치관	NNG
감소/NNG	4급	감소	NNG
개인주의/NNG	5급	개인주의	NNG
결과/NNG	2급	결과	NNG
결혼/NNG	2급	결혼	NNG
계획/NNG	1급	계획	NNG
고정/NNG	4급	고정	NNG
공동/NNG	3급	공동	NNG
과거/NNG	2급	과거	NNG
관념/NNG	6급	관념	NNG
교육비/NNG	4급	교육비	NNG
구분/NNG	4급	구분	NNG
그중/NNG	3급	그중	NNG
남녀/NNG	2급	남녀	NNG
남성/NNG	2급	남성	NNG
남편/NNG	1급	남편	NNG
다음/NNG	1급	다음	NNG
담당/NNG	4급	담당	NNG
답/NNG	2급	답	NNG
대부분/NNG	2급	대부분	NNG
뒤/NNG	1급	뒤	NNG
딸/NNG	1급	딸	NNG
마지막/NNG	2급	마지막	NNG
먼저/NNG	1급	먼저	NNG
몫/NNG	4급	몫	NNG
미혼/NNG	4급	미혼	NNG
바깥일/NNG	5급	바깥일	NNG
반면/NNG	3급	반면	NNG
변화/NNG	3급	변화	NNG
부담/NNG	3급	부담	NNG
부담감/NNG	5급	부담감	NNG
부부/NNG	2급	부부	NNG
비율/NNG	4급	비율	NNG
사람/NNG	1급	사람	NNG
사항/NNG	3급	사항	NNG
생각/NNG	1급	생각	NNG
선호/NNG	4급	선호	NNG
설문/NNG	3급	설문	NNG
실시/NNG	4급	실시	NNG
아내/NNG	1급	아내	NNG
아들/NNG	2급	아들	NNG
아이/NNG	1급	아이	NNG
양육/NNG	5급	양육	NNG
여성/NNG	2급	여성	NNG
예상/NNG	3급	예상	NNG
요즘/NNG	1급	요즘	NNG
육아/NNG	5급	육아	NNG
응답/NNG	4급	응답	NNG
이번/NNG	1급	이번	NNG
이상적/NNG	4급	이상적	NNG
이유/NNG	1급	이유	NNG
자녀/NNG	3급	자녀	NNG
정리/NNG	2급	정리	NNG
중심/NNG	2급	중심	NNG
중요/NNG	2급	중요	NNG
질문/NNG	1급	질문	NNG
집안일/NNG	2급	집안일	NNG
차지/NNG	5급	차지	NNG
최근/NNG	2급	최근	NNG
추측/NNG	3급	추측	NNG
출산율/NNG	5급	출산율	NNG
필수/NNG	4급	필수	NNG
필요/NNG	1급	필요	NNG
한국인/NNG	3급	한국인	NNG
확산/NNG	4급	확산	NNG
후/NNG	1급	후	NNG
가장/MAG	1급	가장	MA
그러나/MAJ	2급	그러나	MA
그리고/MAG	1급	그리고	MA
그리고/MAJ	1급	그리고	MA
꾸준히/MAG	3급	꾸준히	MA
따라서/MAJ	3급	따라서	MA
또한/MAG	3급	또한	MA
많이/MAG	1급	많이	MA
여전히/MAG	4급	여전히	MA
의외로/MAG	5급	의외로	MA
특히/MAG	1급	특히	MA
