갖/VV	2급	갖다	VV
나서/VV	4급	나서다	VV
누리/VV	5급	누리다	VV
되/VV	1급	되다	VV
두/VV	2급	두다	VV
들어서/VV	3급	들어서다	VV
들어오/VV	1급	들어오다	VV
모르/VV	1급	모르다	VV
벌이/VV	4급	벌이다	VV
벗/VV	2급	벗다	VV
보이/VV	2급	보이다	VV
부딪히/VV	4급	부딪히다	VV
얻/VV	2급	얻다	VV
위하/VV	3급	위하다	VV
차/VV	2급	차다	VV
찾/VV	1급	찾다	VV
찾아보/VV	1급	찾아보다	VV
통하/VV	3급	통하다	VV
풀/VV	2급	풀다	VV
하/VV	1급	하다	VV
그렇/VA	1급	그렇다	VA
똑같/VA	2급	똑같다	VA
시끄럽/VA	2급	시끄럽다	VA
없/VA	1급	없다	VA
이렇/VA	2급	이렇다	VA
있/VA	1급	있다	VA
개발/NNG	4급	개발	NNG
거부/NNG	5급	거부	NNG
경쟁/NNG	4급	경쟁	NNG
고속/NNG	3급	고속	NNG
공장/NNG	2급	공장	NNG
공항/NNG	1급	공항	NNG
구청/NNG	5급	구청	NNG
극복/NNG	4급	극복	NNG
기본적/NNG	4급	기본적	NNG
노력/NNG	2급	노력	NNG
노선/NNG	3급	노선	NNG
대규모/NNG	4급	대규모	NNG
대기업/NNG	4급	대기업	NNG
대표적/NNG	3급	대표적	NNG
대화/NNG	1급	대화	NNG
도움/NNG	2급	도움	NNG
동시/NNG	2급	동시	NNG
때/NNG	4급	때	NNG
뜻/NNG	2급	뜻	NNG
만약/NNG	2급	만약	NNG
문제/NNG	2급	문제	NNG
바탕/NNG	3급	바탕	NNG
반대/NNG	2급	반대	NNG
반면/NNG	3급	반면	NNG
반발/NNG	4급	반발	NNG
발/NNG	1급	발	NNG
발전소/NNG	5급	발전소	NNG
방법/NNG	2급	방법	NNG
법원/NNG	4급	법원	NNG
보편화/NNG	5급	보편화	NNG
복지/NNG	5급	복지	NNG
사람/NNG	1급	사람	NNG
사업/NNG	2급	사업	NNG
상응/NNG	6급	상응	NNG
상황/NNG	3급	상황	NNG
생산/NNG	4급	생산	NNG
선정/NNG	4급	선정	NNG
설치/NNG	4급	설치	NNG
성숙/NNG	4급	성숙	NNG
수입/NNG	3급	수입	NNG
시설/NNG	3급	시설	NNG
시위/NNG	5급	시위	NNG
시행/NNG	4급	시행	NNG
쓰레기/NNG	2급	쓰레기	NNG
원자력/NNG	5급	원자력	NNG
유치/NNG	6급	유치	NNG
의식/NNG	4급	의식	NNG
이기주의/NNG	5급	이기주의	NNG
이웃/NNG	2급	이웃	NNG
이유/NNG	1급	이유	NNG
이익/NNG	4급	이익	NNG
입장/NNG	4급	입장	NNG
재정적/NNG	5급	재정적	NNG
정도/NNG	2급	정도	NNG
정부/NNG	4급	정부	NNG
제기/NNG	5급	제기	NNG
주민/NNG	3급	주민	NNG
주변/NNG	2급	주변	NNG
중요/NNG	2급	중요	NNG
지역/NNG	3급	지역	NNG
철도/NNG	3급	철도	NNG
최근/NNG	2급	최근	NNG
추구/NNG	5급	추구	NNG
태도/NNG	2급	태도	NNG
합리적/NNG	4급	합리적	NNG
행동/NNG	2급	행동	NNG
행복/NNG	2급	행복	NNG
현상/NNG	4급	현상	NNG
혐오/NNG	6급	혐오	NNG
혜택/NNG	4급	혜택	NNG
가득/MAG	2급	가득	MA
가장/MAG	1급	가장	MA
그러나/MAJ	2급	그러나	MA
그리고/MAJ	1급	그리고	MA
따라서/MAJ	3급	따라서	MA
먼저/MAG	1급	먼저	MA
무조건/MAG	3급	무조건	MA
물론/MAG	2급	물론	MA
반드시/MAG	2급	반드시	MA
서로/MAG	2급	서로	MA
안/MAG	1급	안	MA
이제/MAG	2급	이제	MA
절대로/MAG	3급	절대로	MA
제대로/MAG	3급	제대로	MA
