나오/VV	1급	나오다	VV
나타나/VV	2급	나타나다	VV
대하/VV	3급	대하다	VV
알/VV	1급	알다	VV
위하/VV	3급	위하다	VV
잇/VV	3급	잇다	VV
지나/VV	1급	지나다	VV
통하/VV	3급	통하다	VV
하/VV	1급	하다	VV
다르/VA	1급	다르다	VA
맛있/VA	1급	맛있다	VA
신선하/VA	2급	신선하다	VA
있/VA	1급	있다	VA
재미있/VA	1급	재미있다	VA
가격/NNG	1급	가격	NNG
갈비/NNG	1급	갈비	NNG
결과/NNG	2급	결과	NNG
관광객/NNG	2급	관광객	NNG
그래프/NNG	4급	그래프	NNG
나라/NNG	1급	나라	NNG
다양성/NNG	5급	다양성	NNG
뒤/NNG	1급	뒤	NNG
때/NNG	4급	때	NNG
맛/NNG	1급	맛	NNG
메뉴/NNG	1급	메뉴	NNG
문화/NNG	1급	문화	NNG
밖/NNG	1급	밖	NNG
불고기/NNG	1급	불고기	NNG
비빔밥/NNG	1급	비빔밥	NNG
삼겹살/NNG	2급	삼겹살	NNG
삼계탕/NNG	1급	삼계탕	NNG
설문/NNG	3급	설문	NNG
세계화/NNG	4급	세계화	NNG
습관/NNG	2급	습관	NNG
식/NNG	5급	식	NNG
외국인/NNG	1급	외국인	NNG
육식/NNG	5급	육식	NNG
음식/NNG	1급	음식	NNG
음식점/NNG	2급	음식점	NNG
의견/NNG	3급	의견	NNG
이번/NNG	1급	이번	NNG
입맛/NNG	3급	입맛	NNG
재료/NNG	2급	재료	NNG
한국적/NNG	4급	한국적	NNG
한식/NNG	2급	한식	NNG
가장/MAG	1급	가장	MA
더/MAG	1급	더	MA
