가지/VV	1급	가지다	VV
내/VV	2급	내다	VV
돌리/VV	2급	돌리다	VV
돌아다니/VV	3급	돌아다니다	VV
되/VV	1급	되다	VV
들어가/VV	1급	들어가다	VV
모르/VV	1급	모르다	VV
모자라/VV	2급	모자라다	VV
몰려들/VV	4급	몰려들다	VV
몰리/VV	4급	몰리다	VV
바꾸/VV	1급	바꾸다	VV
받/VV	1급	받다	VV
보/VV	1급	보다	VV
비하/VV	3급	비하다	VV
살/VV	1급	살다	VV
설레/VV	4급	설레다	VV
얻/VV	2급	얻다	VV
올라오/VV	2급	올라오다	VV
위하/VV	3급	위하다	VV
주/VV	1급	주다	VV
줄이/VV	2급	줄이다	VV
지내/VV	1급	지내다	VV
찾/VV	1급	찾다	VV
하/VV	1급	하다	VV
향하/VV	3급	향하다	VV
가깝/VA	1급	가깝다	VA
가득하/VA	3급	가득하다	VA
값싸/VA	4급	값싸다	VA
그렇/VA	1급	그렇다	VA
많/VA	1급	많다	VA
새롭/VA	2급	새롭다	VA
심각하/VA	3급	심각하다	VA
어렵/VA	1급	어렵다	VA
없/VA	1급	없다	VA
열악하/VA	6급	열악하다	VA
있/VA	1급	있다	VA
저렴하/VA	3급	저렴하다	VA
적/VA	1급	적다	VA
좋/VA	1급	좋다	VA
친하/VA	1급	친하다	VA
크/VA	1급	크다	VA
가족/NNG	1급	가족	NNG
값/NNG	1급	값	NNG
개인적/NNG	3급	개인적	NNG
걱정/NNG	2급	걱정	NNG
경우/NNG	3급	경우	NNG
계약/NNG	3급	계약	NNG
고생/NNG	3급	고생	NNG
곳/NNG	1급	곳	NNG
공간/NNG	3급	공간	NNG
관심/NNG	2급	관심	NNG
교통비/NNG	2급	교통비	NNG
근처/NNG	1급	근처	NNG
기간/NNG	1급	기간	NNG
기숙사/NNG	1급	기숙사	NNG
꿈/NNG	2급	꿈	NNG
눈/NNG	1급	눈	NNG
대부분/NNG	2급	대부분	NNG
대학/NNG	1급	대학	NNG
대학가/NNG	6급	대학가	NNG
대학교/NNG	1급	대학교	NNG
대학생/NNG	1급	대학생	NNG
돈/NNG	1급	돈	NNG
동안/NNG	1급	동안	NNG
때/NNG	4급	때	NNG
마음/NNG	1급	마음	NNG
모습/NNG	2급	모습	NNG
문제/NNG	2급	문제	NNG
방/NNG	1급	방	NNG
보증금/NNG	5급	보증금	NNG
부담/NNG	3급	부담	NNG
부모님/NNG	1급	부모님	NNG
비교적/NNG	4급	비교적	NNG
사람/NNG	1급	사람	NNG
상황/NNG	3급	상황	NNG
생활/NNG	1급	생활	NNG
생활비/NNG	3급	생활비	NNG
시작/NNG	1급	시작	NNG
식비/NNG	3급	식비	NNG
신청/NNG	2급	신청	NNG
신혼부부/NNG	3급	신혼부부	NNG
여가/NNG	3급	여가	NNG
여기저기/NNG	2급	여기저기	NNG
운/NNG	3급	운	NNG
월세/NNG	3급	월세	NNG
이외/NNG	4급	이외	NNG
이제/NNG	2급	이제	NNG
적극적/NNG	4급	적극적	NNG
전세/NNG	3급	전세	NNG
정도/NNG	2급	정도	NNG
주거/NNG	5급	주거	NNG
지역/NNG	3급	지역	NNG
집/NNG	1급	집	NNG
집값/NNG	5급	집값	NNG
집세/NNG	3급	집세	NNG
친구/NNG	1급	친구	NNG
학기/NNG	2급	학기	NNG
학생/NNG	1급	학생	NNG
현실/NNG	4급	현실	NNG
환경/NNG	4급	환경	NNG
굉장히/MAG	3급	굉장히	MA
그래서/MAJ	1급	그래서	MA
그렇지만/MAJ	1급	그렇지만	MA
그리고/MAJ	1급	그리고	MA
너무/MAG	1급	너무	MA
더욱/MAG	2급	더욱	MA
또는/MAG	2급	또는	MA
많이/MAG	1급	많이	MA
매달/MAG	2급	매달	MA
상관없이/MAG	4급	상관없이	MA
실제로/MAG	3급	실제로	MA
없이/MAG	3급	없이	MA
자주/MAG	1급	자주	MA
하지만/MAJ	1급	하지만	MA
함께/MAG	1급	함께	MA
현재/MAG	2급	현재	MA
