가/VV	1급	가다	VV
갖추/VV	4급	갖추다	VV
늘/VV	2급	늘다	VV
맞추/VV	2급	맞추다	VV
보내/VV	1급	보내다	VV
인하/VV	4급	인하다	VV
입/VV	1급	입다	VV
지내/VV	1급	지내다	VV
지키/VV	2급	지키다	VV
하/VV	1급	하다	VV
같/VA	1급	같다	VA
길/VA	1급	길다	VA
많/VA	1급	많다	VA
바쁘/VA	1급	바쁘다	VA
성대하/VA	5급	성대하다	VA
어렵/VA	1급	어렵다	VA
없/VA	1급	없다	VA
있/VA	1급	있다	VA
작/VA	1급	작다	VA
친하/VA	1급	친하다	VA
크/VA	1급	크다	VA
가/NNG	5급	가	NNG
가전제품/NNG	3급	가전제품	NNG
겨울/NNG	1급	겨울	NNG
결과/NNG	2급	결과	NNG
결혼/NNG	2급	결혼	NNG
결혼식/NNG	2급	결혼식	NNG
경우/NNG	3급	경우	NNG
계절/NNG	1급	계절	NNG
계획/NNG	1급	계획	NNG
과거/NNG	2급	과거	NNG
관계/NNG	2급	관계	NNG
관습/NNG	5급	관습	NNG
구매/NNG	4급	구매	NNG
규모/NNG	4급	규모	NNG
기회/NNG	2급	기회	NNG
남자/NNG	1급	남자	NNG
대부분/NNG	2급	대부분	NNG
대여/NNG	5급	대여	NNG
때/NNG	4급	때	NNG
문화/NNG	1급	문화	NNG
물품/NNG	5급	물품	NNG
부모님/NNG	1급	부모님	NNG
비용/NNG	3급	비용	NNG
사람/NNG	1급	사람	NNG
사진/NNG	1급	사진	NNG
생각/NNG	1급	생각	NNG
설문/NNG	3급	설문	NNG
수저/NNG	2급	수저	NNG
순위/NNG	4급	순위	NNG
시간/NNG	1급	시간	NNG
신랑/NNG	2급	신랑	NNG
신혼/NNG	3급	신혼	NNG
신혼여행/NNG	2급	신혼여행	NNG
실속/NNG	5급	실속	NNG
실용적/NNG	4급	실용적	NNG
아기/NNG	1급	아기	NNG
여름/NNG	1급	여름	NNG
여자/NNG	1급	여자	NNG
여행/NNG	1급	여행	NNG
여행지/NNG	2급	여행지	NNG
예산/NNG	4급	예산	NNG
예의/NNG	3급	예의	NNG
예전/NNG	5급	예전	NNG
요즘/NNG	1급	요즘	NNG
위주/NNG	5급	위주	NNG
의미/NNG	2급	의미	NNG
이때/NNG	2급	이때	NNG
이불/NNG	2급	이불	NNG
저녁/NNG	1급	저녁	NNG
주말/NNG	1급	주말	NNG
지인/NNG	6급	지인	NNG
집/NNG	1급	집	NNG
촬영/NNG	3급	촬영	NNG
최고/NNG	2급	최고	NNG
추세/NNG	5급	추세	NNG
친척/NNG	2급	친척	NNG
평소/NNG	2급	평소	NNG
평일/NNG	2급	평일	NNG
품목/NNG	5급	품목	NNG
하객/NNG	5급	하객	NNG
한복/NNG	1급	한복	NNG
해외/NNG	2급	해외	NNG
휴양지/NNG	4급	휴양지	NNG
가장/MAG	1급	가장	MA
같이/MAG	1급	같이	MA
거의/MAG	2급	거의	MA
그래서/MAJ	1급	그래서	MA
그러나/MAJ	2급	그러나	MA
그리고/MAJ	1급	그리고	MA
더/MAG	1급	더	MA
마음대로/MAG	3급	마음대로	MA
많이/MAG	1급	많이	MA
모두/MAG	1급	모두	MA
및/MAG	3급	및	MA
반드시/MAG	2급	반드시	MA
아낌없이/MAG	6급	아낌없이	MA
언제/MAG	1급	언제	MA
없이/MAG	3급	없이	MA
점점/MAG	2급	점점	MA
하지만/MAJ	1급	하지만	MA
