가/VV	1급	가다	VV
가지/VV	1급	가지다	VV
기다리/VV	1급	기다리다	VV
기울이/VV	4급	기울이다	VV
꿈꾸/VV	4급	꿈꾸다	VV
나타나/VV	2급	나타나다	VV
느끼/VV	2급	느끼다	VV
다가가/VV	4급	다가가다	VV
다하/VV	2급	다하다	VV
대하/VV	3급	대하다	VV
되/VV	1급	되다	VV
둘러보/VV	4급	둘러보다	VV
몰두하/VV	5급	몰두하다	VV
받/VV	1급	받다	VV
벗어나/VV	4급	벗어나다	VV
보이/VV	2급	보이다	VV
비하/VV	3급	비하다	VV
얻/VV	2급	얻다	VV
오/VV	1급	오다	VV
옮기/VV	3급	옮기다	VV
원하/VV	2급	원하다	VV
위하/VV	3급	위하다	VV
인하/VV	4급	인하다	VV
자라나/VV	4급	자라나다	VV
지치/VV	4급	지치다	VV
펼쳐지/VV	4급	펼쳐지다	VV
하/VV	1급	하다	VV
같/VA	1급	같다	VA
길/VA	1급	길다	VA
깊/VA	2급	깊다	VA
높/VA	1급	높다	VA
다르/VA	1급	다르다	VA
많/VA	1급	많다	VA
빠르/VA	1급	빠르다	VA
새롭/VA	2급	새롭다	VA
어둡/VA	2급	어둡다	VA
없/VA	1급	없다	VA
있/VA	1급	있다	VA
자연스럽/VA	4급	자연스럽다	VA
조급하/VA	6급	조급하다	VA
좋/VA	1급	좋다	VA
짧/VA	2급	짧다	VA
가운데/NNG	1급	가운데	NNG
거짓/NNG	4급	거짓	NNG
결과/NNG	2급	결과	NNG
결혼/NNG	2급	결혼	NNG
경쟁/NNG	4급	경쟁	NNG
계발/NNG	5급	계발	NNG
곳/NNG	1급	곳	NNG
공부/NNG	1급	공부	NNG
구속/NNG	4급	구속	NNG
귀/NNG	1급	귀	NNG
극도/NNG	6급	극도	NNG
글/NNG	1급	글	NNG
글씨/NNG	2급	글씨	NNG
글자/NNG	2급	글자	NNG
기회/NNG	2급	기회	NNG
길/NNG	1급	길	NNG
남녀/NNG	2급	남녀	NNG
노동/NNG	4급	노동	NNG
눈앞/NNG	4급	눈앞	NNG
단적/NNG	6급	단적	NNG
대부분/NNG	2급	대부분	NNG
때/NNG	4급	때	NNG
뜻/NNG	2급	뜻	NNG
마음/NNG	1급	마음	NNG
마음속/NNG	4급	마음속	NNG
만남/NNG	3급	만남	NNG
무기력/NNG	6급	무기력	NNG
무한/NNG	6급	무한	NNG
미덕/NNG	6급	미덕	NNG
미래/NNG	2급	미래	NNG
미혼/NNG	4급	미혼	NNG
발/NNG	1급	발	NNG
발길/NNG	4급	발길	NNG
분야/NNG	4급	분야	NNG
분위기/NNG	2급	분위기	NNG
사람/NNG	1급	사람	NNG
사회적/NNG	3급	사회적	NNG
상당수/NNG	5급	상당수	NNG
설문/NNG	3급	설문	NNG
소리/NNG	2급	소리	NNG
속도/NNG	2급	속도	NNG
손/NNG	1급	손	NNG
시간/NNG	1급	시간	NNG
신체/NNG	3급	신체	NNG
압박감/NNG	6급	압박감	NNG
애인/NNG	2급	애인	NNG
어려움/NNG	3급	어려움	NNG
에너지/NNG	4급	에너지	NNG
여유/NNG	3급	여유	NNG
연애/NNG	4급	연애	NNG
외국어/NNG	1급	외국어	NNG
요즘/NNG	1급	요즘	NNG
의욕적/NNG	6급	의욕적	NNG
이야기/NNG	1급	이야기	NNG
자격증/NNG	4급	자격증	NNG
전문가/NNG	3급	전문가	NNG
정보/NNG	3급	정보	NNG
정신적/NNG	4급	정신적	NNG
조금/NNG	1급	조금	NNG
주변/NNG	2급	주변	NNG
증후군/NNG	6급	증후군	NNG
직장인/NNG	3급	직장인	NNG
진실/NNG	4급	진실	NNG
집/NNG	1급	집	NNG
최선/NNG	3급	최선	NNG
취득/NNG	5급	취득	NNG
측면/NNG	4급	측면	NNG
친구/NNG	1급	친구	NNG
퇴근/NNG	1급	퇴근	NNG
평소/NNG	2급	평소	NNG
현상/NNG	4급	현상	NNG
회사/NNG	1급	회사	NNG
휴식/NNG	3급	휴식	NNG
가까이/MAG	2급	가까이	MA
굳이/MAG	4급	굳이	MA
너무/MAG	1급	너무	MA
늘/MAG	2급	늘	MA
더/MAG	1급	더	MA
멀리/MAG	2급	멀리	MA
스스로/MAG	2급	스스로	MA
언젠가/MAG	4급	언젠가	MA
천천히/MAG	1급	천천히	MA
활짝/MAG	3급	활짝	MA
