가/VV	1급	가다	VV
건네/VV	4급	건네다	VV
겪/VV	4급	겪다	VV
남/VV	2급	남다	VV
놀라/VV	2급	놀라다	VV
누르/VV	2급	누르다	VV
다가오/VV	4급	다가오다	VV
덜/VV	3급	덜다	VV
돌아오/VV	1급	돌아오다	VV
되/VV	1급	되다	VV
뛰어넘/VV	3급	뛰어넘다	VV
만나/VV	1급	만나다	VV
받아들이/VV	4급	받아들이다	VV
보이/VV	2급	보이다	VV
살/VV	1급	살다	VV
살펴보/VV	3급	살펴보다	VV
생기/VV	2급	생기다	VV
쓰이/VV	3급	쓰이다	VV
알/VV	1급	알다	VV
알아듣/VV	3급	알아듣다	VV
열/VV	1급	열다	VV
오/VV	1급	오다	VV
이르/VV	4급	이르다	VV
이어지/VV	4급	이어지다	VV
인하/VV	4급	인하다	VV
지나/VV	1급	지나다	VV
커지/VV	3급	커지다	VV
하/VV	1급	하다	VV
놀랍/VA	4급	놀랍다	VA
빠르/VA	1급	빠르다	VA
어렵/VA	1급	어렵다	VA
있/VA	1급	있다	VA
가늠/NNG	6급	가늠	NNG
가능/NNG	3급	가능	NNG
가능성/NNG	4급	가능성	NNG
가속화/NNG	5급	가속화	NNG
가스/NNG	3급	가스	NNG
가전제품/NNG	3급	가전제품	NNG
걱정/NNG	2급	걱정	NNG
공개/NNG	4급	공개	NNG
과학/NNG	3급	과학	NNG
교통수단/NNG	3급	교통수단	NNG
구매/NNG	4급	구매	NNG
기기/NNG	6급	기기	NNG
기대/NNG	3급	기대	NNG
기사/NNG	3급	기사	NNG
기한/NNG	5급	기한	NNG
낭비/NNG	4급	낭비	NNG
내부/NNG	4급	내부	NNG
냉장고/NNG	2급	냉장고	NNG
대부분/NNG	2급	대부분	NNG
대형/NNG	3급	대형	NNG
두려움/NNG	4급	두려움	NNG
때/NNG	4급	때	NNG
목소리/NNG	2급	목소리	NNG
문/NNG	1급	문	NNG
문제/NNG	2급	문제	NNG
미래/NNG	2급	미래	NNG
바둑/NNG	3급	바둑	NNG
밖/NNG	1급	밖	NNG
발달/NNG	3급	발달	NNG
발생/NNG	4급	발생	NNG
보관/NNG	3급	보관	NNG
불필요/NNG	4급	불필요	NNG
비행기/NNG	1급	비행기	NNG
사람/NNG	1급	사람	NNG
사진/NNG	1급	사진	NNG
삶/NNG	3급	삶	NNG
상황/NNG	3급	상황	NNG
생산/NNG	4급	생산	NNG
설정/NNG	4급	설정	NNG
설치/NNG	4급	설치	NNG
성능/NNG	5급	성능	NNG
세계/NNG	2급	세계	NNG
속도/NNG	2급	속도	NNG
승리/NNG	4급	승리	NNG
시대/NNG	3급	시대	NNG
시속/NNG	5급	시속	NNG
시일/NNG	4급	시일	NNG
식품/NNG	2급	식품	NNG
실시간/NNG	5급	실시간	NNG
앞/NNG	1급	앞	NNG
어려움/NNG	3급	어려움	NNG
에너지/NNG	4급	에너지	NNG
예상/NNG	3급	예상	NNG
외출/NNG	2급	외출	NNG
우려/NNG	4급	우려	NNG
운행/NNG	4급	운행	NNG
유통/NNG	4급	유통	NNG
이유/NNG	1급	이유	NNG
인간/NNG	4급	인간	NNG
인공/NNG	4급	인공	NNG
인명/NNG	5급	인명	NNG
자동/NNG	3급	자동	NNG
전망/NNG	3급	전망	NNG
조명/NNG	4급	조명	NNG
주인/NNG	1급	주인	NNG
주택/NNG	4급	주택	NNG
지금/NNG	1급	지금	NNG
지능/NNG	4급	지능	NNG
집/NNG	1급	집	NNG
집안/NNG	3급	집안	NNG
체감/NNG	5급	체감	NNG
초인종/NNG	5급	초인종	NNG
최고/NNG	2급	최고	NNG
카메라/NNG	1급	카메라	NNG
탑승/NNG	3급	탑승	NNG
태양열/NNG	5급	태양열	NNG
편리/NNG	2급	편리	NNG
프로그램/NNG	1급	프로그램	NNG
한계/NNG	4급	한계	NNG
해결/NNG	3급	해결	NNG
향상/NNG	4급	향상	NNG
화제/NNG	4급	화제	NNG
확인/NNG	3급	확인	NNG
환경/NNG	4급	환경	NNG
활용/NNG	4급	활용	NNG
획기적/NNG	6급	획기적	NNG
후/NNG	1급	후	NNG
게다가/MAG	4급	게다가	MA
그리고/MAJ	1급	그리고	MA
더/MAG	1급	더	MA
더욱/MAG	2급	더욱	MA
또한/MAG	3급	또한	MA
먼저/MAG	1급	먼저	MA
물론/MAG	2급	물론	MA
미리/MAG	2급	미리	MA
바로/MAG	1급	바로	MA
부쩍/MAG	5급	부쩍	MA
아직/MAG	1급	아직	MA
언제/MAG	1급	언제	MA
점점/MAG	2급	점점	MA
하지만/MAJ	1급	하지만	MA
함께/MAG	1급	함께	MA
