이러하	VA
건강하	VA
기대하	VV
클	NNG
라키	NNP
이상하	VA
알람	NNG
달리	VV
변신하	VV
트레이너	NNG
팔다리	NNG
귄	NNG
다양하	VA
활용하	VV
운동하	VV
감	VV
스트레칭	NNG
꽂이	NNG
시작하	VV
빠지	VV
걱정하	VV
사랑하	VV
강력하	VA
선물하	VV
생각하	VV
추천하	VV
기침하	VV
담뱃재	NNG
