가지/VV	1급	가지다	VV
끝나/VV	1급	끝나다	VV
바라/VV	2급	바라다	VV
오/VV	1급	오다	VV
건강/NNG	1급	건강	NNG
검진/NNG	5급	검진	NNG
결과/NNG	2급	결과	NNG
교내/NNG	4급	교내	NNG
기간/NNG	1급	기간	NNG
기숙사/NNG	1급	기숙사	NNG
대학/NNG	1급	대학	NNG
무료/NNG	2급	무료	NNG
문의/NNG	3급	문의	NNG
보건/NNG	6급	보건	NNG
비용/NNG	3급	비용	NNG
사항/NNG	3급	사항	NNG
소변/NNG	3급	소변	NNG
시력/NNG	4급	시력	NNG
식사/NNG	1급	식사	NNG
신분/NNG	3급	신분	NNG
신분증/NNG	2급	신분증	NNG
신입생/NNG	3급	신입생	NNG
신장/NNG	5급	신장	NNG
아래/NNG	1급	아래	NNG
아침/NNG	1급	아침	NNG
안내/NNG	1급	안내	NNG
예정/NNG	3급	예정	NNG
이메일/NNG	3급	이메일	NNG
장소/NNG	1급	장소	NNG
저녁/NNG	1급	저녁	NNG
전날/NNG	3급	전날	NNG
체중/NNG	4급	체중	NNG
층/NNG	1급	층	NNG
항목/NNG	5급	항목	NNG
혈압/NNG	5급	혈압	NNG
확인/NNG	3급	확인	NNG
후/NNG	1급	후	NNG
같이/MAG	1급	같이	MA
반드시/MAG	2급	반드시	MA
