가/VV	1급	가다	VV
끝나/VV	1급	끝나다	VV
나오/VV	1급	나오다	VV
나타나/VV	2급	나타나다	VV
들/VV	1급	들다	VV
물어보/VV	2급	물어보다	VV
배우/VV	1급	배우다	VV
벌/VV	2급	벌다	VV
사귀/VV	1급	사귀다	VV
생기/VV	2급	생기다	VV
알리/VV	1급	알리다	VV
찾/VV	1급	찾다	VV
하/VV	1급	하다	VV
같/VA	1급	같다	VA
많/VA	1급	많다	VA
맵/VA	1급	맵다	VA
바쁘/VA	1급	바쁘다	VA
비싸/VA	1급	비싸다	VA
슬프/VA	1급	슬프다	VA
아프/VA	1급	아프다	VA
어렵/VA	1급	어렵다	VA
없/VA	1급	없다	VA
익숙하/VA	2급	익숙하다	VA
있/VA	1급	있다	VA
적/VA	1급	적다	VA
좋/VA	1급	좋다	VA
힘들/VA	1급	힘들다	VA
각종/NNG	4급	각종	NNG
값/NNG	1급	값	NNG
결과/NNG	2급	결과	NNG
고기/NNG	1급	고기	NNG
과일/NNG	1급	과일	NNG
구입/NNG	3급	구입	NNG
기회/NNG	2급	기회	NNG
다음/NNG	1급	다음	NNG
대답/NNG	1급	대답	NNG
대부분/NNG	2급	대부분	NNG
대학생/NNG	1급	대학생	NNG
드라마/NNG	1급	드라마	NNG
때/NNG	4급	때	NNG
마지막/NNG	2급	마지막	NNG
몸/NNG	1급	몸	NNG
문제/NNG	2급	문제	NNG
문화/NNG	1급	문화	NNG
물가/NNG	3급	물가	NNG
방/NNG	1급	방	NNG
병원/NNG	1급	병원	NNG
보험/NNG	3급	보험	NNG
비자/NNG	3급	비자	NNG
생각/NNG	1급	생각	NNG
생활/NNG	1급	생활	NNG
세계적/NNG	4급	세계적	NNG
소통/NNG	5급	소통	NNG
수업/NNG	1급	수업	NNG
시간/NNG	1급	시간	NNG
시험/NNG	1급	시험	NNG
아르바이트/NNG	1급	아르바이트	NNG
양념/NNG	3급	양념	NNG
어려움/NNG	3급	어려움	NNG
여가/NNG	3급	여가	NNG
외국/NNG	1급	외국	NNG
외국인/NNG	1급	외국인	NNG
용돈/NNG	3급	용돈	NNG
유학생/NNG	2급	유학생	NNG
음식/NNG	1급	음식	NNG
의료/NNG	5급	의료	NNG
의사소통/NNG	5급	의사소통	NNG
이용/NNG	2급	이용	NNG
일부/NNG	2급	일부	NNG
준비/NNG	1급	준비	NNG
초기/NNG	4급	초기	NNG
취업/NNG	4급	취업	NNG
친구/NNG	1급	친구	NNG
프로그램/NNG	1급	프로그램	NNG
학생/NNG	1급	학생	NNG
한국인/NNG	3급	한국인	NNG
활용/NNG	4급	활용	NNG
효율적/NNG	4급	효율적	NNG
후/NNG	1급	후	NNG
가장/MAG	1급	가장	MA
꾸준히/MAG	3급	꾸준히	MA
너무/MAG	1급	너무	MA
또한/MAG	3급	또한	MA
많이/MAG	1급	많이	MA
및/MAG	3급	및	MA
저절로/MAG	4급	저절로	MA
하지만/MAJ	1급	하지만	MA
항상/MAG	2급	항상	MA
