가르치/VV	1급	가르치다	VV
바라/VV	2급	바라다	VV
배우/VV	1급	배우다	VV
하/VV	1급	하다	VV
있/VA	1급	있다	VA
개인/NNG	3급	개인	NNG
결정/NNG	2급	결정	NNG
경험/NNG	2급	경험	NNG
고급/NNG	4급	고급	NNG
과외/NNG	4급	과외	NNG
관심/NNG	2급	관심	NNG
그룹/NNG	3급	그룹	NNG
근무/NNG	3급	근무	NNG
급여/NNG	5급	급여	NNG
기초/NNG	3급	기초	NNG
동안/NNG	1급	동안	NNG
모집/NNG	3급	모집	NNG
서비스/NNG	2급	서비스	NNG
성격/NNG	2급	성격	NNG
손님/NNG	1급	손님	NNG
수준/NNG	4급	수준	NNG
시간/NNG	1급	시간	NNG
아르바이트/NNG	1급	아르바이트	NNG
연락/NNG	2급	연락	NNG
연락처/NNG	2급	연락처	NNG
오후/NNG	1급	오후	NNG
외국인/NNG	1급	외국인	NNG
위치/NNG	2급	위치	NNG
인원/NNG	3급	인원	NNG
일본인/NNG	3급	일본인	NNG
초등학생/NNG	2급	초등학생	NNG
통역/NNG	3급	통역	NNG
판매/NNG	3급	판매	NNG
학생/NNG	1급	학생	NNG
학원/NNG	2급	학원	NNG
화장품/NNG	2급	화장품	NNG
후/NNG	1급	후	NNG
또는/MAG	2급	또는	MA
모두/MAG	1급	모두	MA
바로/MAG	1급	바로	MA
