나누/VV	2급	나누다	VV
내리/VV	1급	내리다	VV
느끼/VV	2급	느끼다	VV
늘어나/VV	3급	늘어나다	VV
다녀오/VV	1급	다녀오다	VV
달하/VV	4급	달하다	VV
대하/VV	3급	대하다	VV
덮이/VV	4급	덮이다	VV
듣/VV	1급	듣다	VV
떠나/VV	2급	떠나다	VV
떠오르/VV	3급	떠오르다	VV
받/VV	1급	받다	VV
배우/VV	1급	배우다	VV
벗어나/VV	4급	벗어나다	VV
변하/VV	2급	변하다	VV
보/VV	1급	보다	VV
비하/VV	3급	비하다	VV
뻗/VV	4급	뻗다	VV
세우/VV	2급	세우다	VV
어울리/VV	2급	어울리다	VV
의하/VV	5급	의하다	VV
짓/VV	2급	짓다	VV
펼쳐지/VV	4급	펼쳐지다	VV
하/VV	1급	하다	VV
높/VA	1급	높다	VA
많/VA	1급	많다	VA
아름답/VA	1급	아름답다	VA
있/VA	1급	있다	VA
가까이/NNG	2급	가까이	NNG
각도/NNG	6급	각도	NNG
갈래/NNG	6급	갈래	NNG
강/NNG	2급	강	NNG
거리/NNG	2급	거리	NNG
건물/NNG	1급	건물	NNG
건축/NNG	4급	건축	NNG
공원/NNG	1급	공원	NNG
공중/NNG	5급	공중	NNG
국내/NNG	2급	국내	NNG
기간/NNG	1급	기간	NNG
길이/NNG	2급	길이	NNG
끝/NNG	2급	끝	NNG
남부/NNG	3급	남부	NNG
노랑/NNG	3급	노랑	NNG
높이/NNG	2급	높이	NNG
당시/NNG	4급	당시	NNG
도시/NNG	2급	도시	NNG
동물/NNG	2급	동물	NNG
동안/NNG	1급	동안	NNG
때/NNG	4급	때	NNG
명소/NNG	5급	명소	NNG
모습/NNG	2급	모습	NNG
묘지/NNG	6급	묘지	NNG
봉우리/NNG	6급	봉우리	NNG
북부/NNG	3급	북부	NNG
비난/NNG	4급	비난	NNG
비중/NNG	4급	비중	NNG
사람/NNG	1급	사람	NNG
사랑/NNG	1급	사랑	NNG
사자/NNG	3급	사자	NNG
산/NNG	1급	산	NNG
색깔/NNG	2급	색깔	NNG
서쪽/NNG	2급	서쪽	NNG
설계/NNG	5급	설계	NNG
세계/NNG	2급	세계	NNG
소리/NNG	2급	소리	NNG
소음/NNG	4급	소음	NNG
야경/NNG	3급	야경	NNG
야생/NNG	5급	야생	NNG
여름/NNG	1급	여름	NNG
여름휴가/NNG	3급	여름휴가	NNG
여행/NNG	1급	여행	NNG
여행사/NNG	1급	여행사	NNG
여행지/NNG	2급	여행지	NNG
올/NNG	3급	올	NNG
이미지/NNG	3급	이미지	NNG
자연/NNG	2급	자연	NNG
작년/NNG	1급	작년	NNG
전망대/NNG	6급	전망대	NNG
죽음/NNG	3급	죽음	NNG
지붕/NNG	3급	지붕	NNG
지지/NNG	5급	지지	NNG
질서/NNG	4급	질서	NNG
최고/NNG	2급	최고	NNG
코끼리/NNG	2급	코끼리	NNG
탑/NNG	4급	탑	NNG
태양/NNG	4급	태양	NNG
풍선/NNG	3급	풍선	NNG
하루/NNG	1급	하루	NNG
한국인/NNG	3급	한국인	NNG
해발/NNG	6급	해발	NNG
해외/NNG	2급	해외	NNG
해외여행/NNG	2급	해외여행	NNG
혁명/NNG	5급	혁명	NNG
형식/NNG	4급	형식	NNG
황제/NNG	6급	황제	NNG
후/NNG	1급	후	NNG
가장/MAG	1급	가장	MA
그대로/MAG	2급	그대로	MA
먼저/MAG	1급	먼저	MA
아주/MAG	1급	아주	MA
해마다/MAG	2급	해마다	MA
