걸리/VV	1급	걸리다	VV
그만두/VV	2급	그만두다	VV
그치/VV	2급	그치다	VV
나무라/VV	4급	나무라다	VV
나서/VV	4급	나서다	VV
나타나/VV	2급	나타나다	VV
내/VV	2급	내다	VV
늘/VV	2급	늘다	VV
되/VV	1급	되다	VV
머물/VV	4급	머물다	VV
몰리/VV	4급	몰리다	VV
미치/VV	4급	미치다	VV
생기/VV	2급	생기다	VV
오르/VV	2급	오르다	VV
이르/VV	4급	이르다	VV
인하/VV	4급	인하다	VV
잇/VV	3급	잇다	VV
잡/VV	2급	잡다	VV
찾/VV	1급	찾다	VV
길/VA	1급	길다	VA
낫/VA	2급	낫다	VA
높/VA	1급	높다	VA
어렵/VA	1급	어렵다	VA
없/VA	1급	없다	VA
이렇/VA	2급	이렇다	VA
각자/NNG	3급	각자	NNG
결과/NNG	2급	결과	NNG
결국/NNG	3급	결국	NNG
경영학/NNG	5급	경영학	NNG
경우/NNG	3급	경우	NNG
경제/NNG	3급	경제	NNG
계약/NNG	3급	계약	NNG
고용/NNG	6급	고용	NNG
공무원/NNG	2급	공무원	NNG
관련/NNG	3급	관련	NNG
교수/NNG	2급	교수	NNG
교원/NNG	5급	교원	NNG
근로/NNG	5급	근로	NNG
근본적/NNG	4급	근본적	NNG
기간/NNG	1급	기간	NNG
기능/NNG	3급	기능	NNG
기대/NNG	3급	기대	NNG
기업체/NNG	6급	기업체	NNG
난/NNG	5급	난	NNG
남자/NNG	1급	남자	NNG
다수/NNG	4급	다수	NNG
달/NNG	1급	달	NNG
대비/NNG	4급	대비	NNG
대책/NNG	4급	대책	NNG
대학교/NNG	1급	대학교	NNG
대학생/NNG	1급	대학생	NNG
마련/NNG	4급	마련	NNG
목소리/NNG	2급	목소리	NNG
몫/NNG	4급	몫	NNG
반면/NNG	3급	반면	NNG
발표/NNG	3급	발표	NNG
변/NNG	6급	변	NNG
분석/NNG	4급	분석	NNG
분야/NNG	4급	분야	NNG
불만족/NNG	3급	불만족	NNG
불안/NNG	2급	불안	NNG
사람/NNG	1급	사람	NNG
사유/NNG	5급	사유	NNG
생활/NNG	1급	생활	NNG
선택/NNG	2급	선택	NNG
세태/NNG	6급	세태	NNG
속/NNG	2급	속	NNG
시간/NNG	1급	시간	NNG
시험/NNG	1급	시험	NNG
실업/NNG	4급	실업	NNG
악화/NNG	4급	악화	NNG
안정적/NNG	5급	안정적	NNG
언론사/NNG	6급	언론사	NNG
여건/NNG	4급	여건	NNG
여자/NNG	1급	여자	NNG
우려/NNG	4급	우려	NNG
원/NNG	4급	원	NNG
응답/NNG	4급	응답	NNG
이유/NNG	1급	이유	NNG
일반/NNG	3급	일반	NNG
일자리/NNG	3급	일자리	NNG
임용/NNG	6급	임용	NNG
입대/NNG	4급	입대	NNG
입사/NNG	4급	입사	NNG
자격증/NNG	4급	자격증	NNG
작년/NNG	1급	작년	NNG
전년/NNG	5급	전년	NNG
전문직/NNG	4급	전문직	NNG
젊은이/NNG	3급	젊은이	NNG
정도/NNG	2급	정도	NNG
정부/NNG	4급	정부	NNG
졸업/NNG	1급	졸업	NNG
준비/NNG	1급	준비	NNG
증가/NNG	3급	증가	NNG
직업/NNG	1급	직업	NNG
직장/NNG	2급	직장	NNG
차지/NNG	5급	차지	NNG
처음/NNG	1급	처음	NNG
청년/NNG	2급	청년	NNG
최대/NNG	4급	최대	NNG
취업/NNG	4급	취업	NNG
통계청/NNG	5급	통계청	NNG
평균/NNG	4급	평균	NNG
학교/NNG	1급	학교	NNG
학생/NNG	1급	학생	NNG
현상/NNG	4급	현상	NNG
현실/NNG	4급	현실	NNG
활동/NNG	3급	활동	NNG
회사/NNG	1급	회사	NNG
후/NNG	1급	후	NNG
휴학/NNG	3급	휴학	NNG
가장/MAG	1급	가장	MA
게다가/MAG	4급	게다가	MA
그러나/MAJ	2급	그러나	MA
더/MAG	1급	더	MA
또한/MAG	3급	또한	MA
못/MAG	1급	못	MA
및/MAJ	3급	및	MA
및/MAG	3급	및	MA
불과/MAG	6급	불과	MA
하지만/MAJ	1급	하지만	MA
