그치/VV	2급	그치다	VV
높아지/VV	3급	높아지다	VV
늘리/VV	3급	늘리다	VV
되/VV	1급	되다	VV
들/VV	1급	들다	VV
미치/VV	4급	미치다	VV
바로잡/VV	4급	바로잡다	VV
시키/VV	1급	시키다	VV
위하/VV	3급	위하다	VV
주/VV	1급	주다	VV
줄이/VV	2급	줄이다	VV
커지/VV	3급	커지다	VV
통하/VV	3급	통하다	VV
펴/VV	2급	펴다	VV
하/VV	1급	하다	VV
같/VA	1급	같다	VA
그렇/VA	1급	그렇다	VA
나쁘/VA	1급	나쁘다	VA
낮/VA	1급	낮다	VA
많/VA	1급	많다	VA
빠르/VA	1급	빠르다	VA
없/VA	1급	없다	VA
있/VA	1급	있다	VA
좋/VA	1급	좋다	VA
지나치/VA	3급	지나치다	VA
크/VA	1급	크다	VA
간접/NNG	5급	간접	NNG
감소/NNG	4급	감소	NNG
개발/NNG	4급	개발	NNG
개입/NNG	6급	개입	NNG
격차/NNG	6급	격차	NNG
경제/NNG	3급	경제	NNG
계획/NNG	1급	계획	NNG
공급/NNG	4급	공급	NNG
관세/NNG	6급	관세	NNG
교육/NNG	2급	교육	NNG
국민/NNG	3급	국민	NNG
국방/NNG	6급	국방	NNG
규제/NNG	6급	규제	NNG
금리/NNG	5급	금리	NNG
기업/NNG	3급	기업	NNG
기회/NNG	2급	기회	NNG
논란/NNG	6급	논란	NNG
대다수/NNG	4급	대다수	NNG
도로/NNG	2급	도로	NNG
모두/NNG	1급	모두	NNG
모습/NNG	2급	모습	NNG
문제/NNG	2급	문제	NNG
물가/NNG	3급	물가	NNG
변동/NNG	4급	변동	NNG
보조금/NNG	6급	보조금	NNG
복지/NNG	5급	복지	NNG
부과/NNG	5급	부과	NNG
부정/NNG	4급	부정	NNG
분배/NNG	6급	분배	NNG
불평등/NNG	4급	불평등	NNG
불황/NNG	6급	불황	NNG
비용/NNG	3급	비용	NNG
빈부/NNG	6급	빈부	NNG
사람/NNG	1급	사람	NNG
사실/NNG	2급	사실	NNG
사용/NNG	1급	사용	NNG
산업/NNG	3급	산업	NNG
상승/NNG	4급	상승	NNG
상품/NNG	2급	상품	NNG
생계/NNG	6급	생계	NNG
생산/NNG	4급	생산	NNG
선진국/NNG	4급	선진국	NNG
세금/NNG	4급	세금	NNG
소득/NNG	4급	소득	NNG
소비/NNG	4급	소비	NNG
소수/NNG	4급	소수	NNG
실업률/NNG	5급	실업률	NNG
악영향/NNG	5급	악영향	NNG
역할/NNG	3급	역할	NNG
연구/NNG	3급	연구	NNG
외국/NNG	1급	외국	NNG
우려/NNG	4급	우려	NNG
유망/NNG	5급	유망	NNG
유지/NNG	4급	유지	NNG
유통/NNG	4급	유통	NNG
인하/NNG	4급	인하	NNG
일부/NNG	2급	일부	NNG
자본/NNG	4급	자본	NNG
자본주의/NNG	6급	자본주의	NNG
재정/NNG	6급	재정	NNG
정도/NNG	2급	정도	NNG
정부/NNG	4급	정부	NNG
정책/NNG	4급	정책	NNG
조세/NNG	6급	조세	NNG
주장/NNG	4급	주장	NNG
주체/NNG	6급	주체	NNG
중요성/NNG	4급	중요성	NNG
지급/NNG	4급	지급	NNG
지출/NNG	4급	지출	NNG
차지/NNG	5급	차지	NNG
초기/NNG	4급	초기	NNG
최저/NNG	3급	최저	NNG
투자/NNG	4급	투자	NNG
특정/NNG	4급	특정	NNG
폭/NNG	5급	폭	NNG
피해/NNG	3급	피해	NNG
필요/NNG	1급	필요	NNG
합리적/NNG	4급	합리적	NNG
해결/NNG	3급	해결	NNG
행동/NNG	2급	행동	NNG
현대/NNG	3급	현대	NNG
호황/NNG	6급	호황	NNG
확대/NNG	4급	확대	NNG
활동/NNG	3급	활동	NNG
같이/MAG	1급	같이	MA
그러나/MAJ	2급	그러나	MA
그러므로/MAJ	2급	그러므로	MA
그리고/MAJ	1급	그리고	MA
달리/MAG	4급	달리	MA
또한/MAG	3급	또한	MA
많이/MAG	1급	많이	MA
물론/MAG	2급	물론	MA
점점/MAG	2급	점점	MA
주로/MAG	1급	주로	MA
직접/MAG	2급	직접	MA
현재/MAG	2급	현재	MA
