시작하	VV
앞자리	NNG
일하	VV
민정	NNP
안녕하	VA
민정	NNP
민정	NNP
민정	NNP
도착하	VV
확인하	VV
검색하	VV
시작되	VV
열중하	VV
배꼽시계	NNG
시작하	VV
피곤하	VA
일하	VV
퇴근길	NNG
퇴근하	VV
편안하	VA
