시작하	VV
이러하	VA
헬렌	NNP
켈러	NNP
설리번	NNP
극복하	VV
온달	NNP
평강	NNP
최민수	NNP
생활하	VV
생각하	VV
대답하	VV
불행하	VA
말씀하	VV
값비싸	VA
생각하	VV
생각하	VV
어쩌	VV
노력하	VV
조종석	NNG
도전하	VV
행복하	VA
최민수	NNP
단비	NNP
