다양하	VA
방송되	VV
방송되	VV
지적하	VV
비슷비슷하	VA
시작하	VV
유사하	VA
제작하	VV
눙	NNG
출연자	NNG
홍보하	VV
이용되	VV
고려하	VV
이용하	VV
출연하	VV
이야기하	VV
출연자	NNG
과장되	VV
과장되	VV
강조하	VV
불필요하	VA
꼭	MAG
필요하	VA
이러하	VA
외면하	VV
차별화되	VV
제작하	VV
