김	NNP
발견되	VV
불편하	VA
신고하	VV
발견되	VV
생각하	VV
현주소	NNG
반영하	VV
무관심하	VA
서로	NNG
밥숟가락	NNG
걷어붙이	VV
분업화	NNG
발달하	VV
수긍하	VV
지속되	VV
김	NNP
보장하	VV
이러하	VA
영수	NNG
딸부자	NNG
수미	NNP
필요하	VA
