우선권	NNG
제외하	VV
기대하	VV
준비되	VV
집주인	NNG
시작하	VV
포기하	VV
활동비	NNG
불편하	VA
룸메이트	NNG
한정되	VV
불편하	VA
그러하	VA
불편하	VA
감수하	VV
생각하	VV
도전하	VV
노력하	VV
생각하	VV
해결하	VV
노력하	VV
