정마	NNG
한국	NNP
변화하	VV
스마트폰	NNG
제작하	VV
스마트폰	NNG
제작하	VV
송출하	VV
아프리카	NNP
팟	NNG
유	NNP
튜브	NNG
소통하	VV
커뮤니케이션	NNG
필요하	VA
지상파	NNG
다양하	VA
작용하	VV
이러하	VA
이류	NNG
시도하	VV
뉴미디어	NNG
계속하	VV
정확하	VA
선정성	NNG
발전하	VV
수정하	VV
해결하	VV
충실하	VA
제작되	VV
필요하	VA
