존재하	VV
다양하	VA
노동부	NNG
반영하	VV
신생	NNG
이색	NNG
추구하	VV
다양하	VA
워터	NNG
소믈리에	NNP
구분하	VV
추천하	VV
다양하	VA
유망하	VA
평판	NNG
평판	NNG
관리하	VV
말하	VV
말하	VV
관리자	NNG
활동하	VV
유지하	VV
수납	NNG
수납	NNG
분리하	VV
수납하	VV
누하	NNG
우	NNG
소개하	VV
분석가	NNG
수유	NNG
증가하	VV
건강하	VA
부족하	VA
사료	NNG
평가사	NNG
장의사	NNG
애견	NNG
사진사	NNG
실시하	VV
제공하	VV
존재하	VV
계속하	VV
취직난	NNG
중요하	VA
다양하	VA
존재하	VV
기억하	VV
발견하	VV
