바늘구멍	NNG
포털	NNG
퇴사자	NNG
결정하	VV
조사되	VV
차지하	VV
장법	NNG
이야기하	VV
중요하	VA
강조하	VV
한국	NNP
식사하	VV
안녕하	VA
사용되	VV
식사하	VV
인사말	NNG
지각하	VV
기키	NNP
가능하	VA
성실하	VA
처리하	VV
중요시하	VV
한국	NNP
사외	NNG
참여하	VV
파악하	VV
말하	VV
한국	NNP
중요하	VA
자이	NNG
기억하	VV
