난타	NNG
한국	NNP
사용하	VV
한국	NNP
정리하	VV
시작하	VV
등장하	VV
지배인	NNG
준비하	VV
요구하	VV
지배인	NNG
시작하	VV
한국	NNP
대표하	VV
난타	NNG
감탄하	VV
이해하	VV
집중하	VV
감사하	VV
난타	NNG
반복되	VV
