소통하	VV
방송하	VV
등장하	VV
모바일	NNG
가능하	VA
먹방	NNG
톡	NNG
이야기하	VV
음방	NNG
다양하	VA
선택하	VV
참여하	VV
댓슌	NNG
머니	NNG
머니	NNG
이러하	VA
증가하	VV
발생하	VV
무분별하	VA
발생되	VV
해결하	VV
규제하	VV
방송되	VV
반성하	VV
이러하	VA
시청하	VV
판단하	VV
소통하	VV
마련하	VV
중요하	VA
생각하	VV
