입학하	VV
선택하	VV
생각하	VV
대화교	NNG
공부하	VV
결석하	VV
헉	MAG
교	NNG
토론하	VV
생각하	VV
가요제	NNG
반대하	VV
히	NNG
생각하	VV
꼭	MAG
화해하	VV
응원하	VV
시작하	VV
졸업하	VV
졸업장	NNG
후회하	VV
말하	VV
