클럽	NNG
이용하	VV
선택하	VV
신청하	VV
입금하	VV
소개하	VV
걷기	NNG
참여하	VV
빙글빙글	MAG
피겨	NNG
스케이팅	NNG
사랑하	VV
힙	NNG
피겨	NNG
아이스	NNG
댄싱	NNG
연습하	VV
연습하	VV
공연하	VV
잠실	NNP
스케이트장	NNG
친절하	VA
도전하	VV
사랑하	VV
방문하	VV
