안녕하	VA
꽃샘	NNG
고민하	VV
공부하	VV
공부하	VV
진학하	VV
생각하	VV
결심하	VV
진학하	VV
필요하	VA
건강하	VA
첨부하	VV
안녕하	VA
졸업하	VV
한스	NNP
취직하	VV
일하	VV
한국어	NNP
행복하	VA
한국	NNP
찾아뵈	VV
격려하	VV
귀국하	VV
꼭	MAG
